%%%%%%%%%%%%%%%%%%%%%%%%%%%%%
%.  ..... %    ....   ...% P%
%. %%%%...%..%%%%%%%%%   %  %
%. %.   %%%%. .   .  %  %%%.%
%. % %%...... .   .  %   ...%
%  % %% % % . %%% .    %%%% %
%F      %   .     .  %    . %
%%%%%%             %%%    ..%
%    %   %%%%%% %%   %%%%%% %
% %% %   %  ....   %     %  %
%F   ....     %    %  %     %
%%%%%%%%%%%%%%%%%%%%%%%%%%%%%